%%%%%%%%%%%%%%%%%%%%%%%%%%%%%%%%%%
%.          .%      %.%.%.%  %  2%
%% %%%%%%%% %%.%      %   %     4%
%.    ..%..  % % .% % % % .      %
%%%% %%%%%%%        % %.% %%% %%%%
%       .   .% %  % %.% . %.. %  %
%     .     .     %.% % % %%%.%  %
%%% % %%%%%%% %%  %       % .    %
%      %.  .. .%  %%%%%%.%% % %  %
%  % % %%.%%%%%%  %. ..  .%      %
%    . %       %  %% %%%%%%% % %%%
%  %.%%% % % %.%     .     .     %
%  % ..% . %.% %  % %.   .       %
%%%% %%% %.% %        %%%%%%% %%%%
%      . % % % %. % %  ..%..    .%
%3     %   %      %.%% %%%%%%%% %%
%1  %  %.%.%.%      %.          .%
%%%%%%%%%%%%%%%%%%%%%%%%%%%%%%%%%%