%%%%%%%%%%%%%%%%%%%%
%    .       .     %
%.%%.%. %%%% .%.%%.%
%%%%%%%      %%%%%%%
%1    %  32  %    4%
%%%%%%%%%%%%%%%%%%%%
